1111111111
1000000001
1000000001
1000000001
1000000001
1000000101
1000000001
1000000001
1000000001
1111111111