1111111111
1000000001
1000000001
10000001011111111
10000000000000001
10000000011111101
10000000010000101
10000000010000101
10000000010000101
10000000011111101
10000000000000001
11111111111111111