NO "img"
SO "img"
WE "img"
EA "img"

F 100,2,0
C 0,0,50

111111111111111111111111111
100000000000000000000000001
100000001110000001111100001
100000110110000010001100001
100001100110000000011000001
100011111111100000110000001
100000000110000011000000001
100000000110000111111000001
100000000N00000000000000001
111111111111111111111111111
