NO ./img/Wallred.png
SO ./img/Wallgrey.png
WE ./img/Walldark.png
EA ./img/Wallblue.png

C 81,100,255
F 69,240,99

            111111111111111
            100000000000001
            100000001100111
            100000001100001
            100000001100001
            100000001111001
            100000001100001
            100000001100001
111111111111100000001100111
100000000000000000000000001
100000001110000001111100001
100000110010000010001100001
100001100010000000011000001
100011111111100000110000001
100000000110000011000000001
100000000110000111111000001
100000000E00000000000000001
100000000000000000000000001 1
111111111111111111111111111

11

11