NO ./img/wallred.png
SO ./img/wallgrey.png
WE ./img/walldark.png
EA ./img/wallblue.png

C 81,100,255
F 69,240,99

            111111111111111
            100000000000001
            1000000011DD111
            100000001100001
            100000001100001
            100000001111DD1
            100000001100001
            100000001100001
11111111111110000000111D111
100000000000000000000000001
100000001110000001111100001
100000110010000010001100001
1000011000D0000000011000001
100011111111100000110000001
10000000011000001100000000111111
10000000011000011111100000D00001
100000000E0000000000000000111111
100000000000000000000000001
111111111111111111111111111
