

		         NO img/Wallgrey1.png




	SO img/Wallblue.png


	           	

WE img/Wallred.png

    EA     img/Walldark2.png

F 69,42,33
C 200,100,69

            11111111
            10000001
            10000001
1111111     10000000
1000001     10000001
1000001111111000000111
10000000000000000000011111
1000000000000000000000000111111111111111111
1S00000000000000000000000000000000000000001
1000000000000000000111111111111111111111111
11111111111111111111